111111111111111
100000000000001
100000000000001
10000000000001G
100000100000000
100000100000000
100000100000000
100000100000000
100000100000000
100000000000001
1000M0000000001
100000000000001
100000000000001
100000000000001
111111111111111