100100000100001
101111100011001
110100010111100
10110011100101G
100001110101111
111101110001011
100100010110011
111011100000011
101111101111111
110101000101000
01010M110111011
100000100000111
101101110111010
100000010000011
101111000111000
