000110111001001
000010000001000
011000111111000
001011100000000
0010100000000G0
001011110110000
001000000000000
001111110110000
000000010100000
000000010100000
000M00000000000
000000000000000
000000000000000
000000000000000
111111111111111