000110111001001
000010000010000
011000111101000
001011000000000
0010100101000G0
001011110110000
001000010100000
001111110110000
000000010100000
000000010111000
000M00000001000
000010000011000
000010010010001
000011110010001
110000000110011